-89
24
-13
14
00000000000000000000000000000000000000000000010000000000000000000001000000000000000000000000000000000000000000000
00000000000000000000000000000000000000000000010000000000000000000001000000000000000000000000000000000000000000000
00000000000000000000000000000000000000000000010000000000000000000001000000000000000000000000000000000000000000000
00000000000000000000000000000000000000000000010000000000000000000001000000000000000000000000000000000000000000000
00000000000000000000000000000000000000000000010000000000000000000001000000000000000000000000000000000000000000000
00000000000000000000000000000000000000000000010000000000000000000001000000000000000000011111110000000000000000000
00000000000000000000000000000000000000000000010000000000000000000001000000000000000000011111110000000000000000000
00000000000000000000000000000000000000000000010000000000000000000001000000000000000000011111110000000000000000000
00000000000000000000000000000000000000000000010000000000000000000001000000000000000000011111110000000000000000000
00000000000000000000000000000000000000000000010000000000000000000001000000000000000000011111110000000000000000000
00000000000000000000000000000000000000000000010000000000000000000001000000000000000000011111110000000000000000000
00000001000010000000000100001000000000000000010000000000000000000001000000000000000000000000000000000000000000000
00000001000010000000000100001000000000000000010000000000000000000001000000000000000000000000000000000001111111000
00000001111110000000000111111000000000000000010000000000000000000001000000000000000000000000000000000001111111000
00000001111110000000000111111000000000000000010000000000000000000001000000000000000000000000000000000001111111000
00000000000000000000000000000000000000000000010000000000000000000001000000000000000000000000000000000001111111000
00000000000000000000000000000000000000000000010000000000000000000001000000000000000100000000000000000001111111000
00000000000000000000000000000000000000000000010000000000000000000001000000000000000000000000000000000001111111000
00000000000000000000000000000000000000000000010000000000000000000001000000000000000000000000000000000000000000000
00000000000000000000000000000000000000000000010000000000000000000001000000000000000000000000000000000000000000000
00000000000000000000000000000000000000000000010000000000000000000001000000000000000000000000000000000000000000000
00000000000000000000000000000000000000000000010000000000000000000001000000000000000000000000000000000000000000000
00000000000000000000000000000000000000000000010000000000000000000001000000000000000000000000000000000000000000000
00000000000000000000000000000000000000000000010000000000000000000001000000000000000000000000000000000000000000000
00000000000000000000000000000000000000000000010000000000000000000001000000000000000000000000000000000000000000000
00000000000000000000000000000000000000000000010000000000000000000001000000000000000000000000000000000000000000000
00000000000000000000000000000000000000000000010000000000000000000001000000000000000000000000000000000000000000000
